00000000000000000000
00r000r00r000rrr0000
0r0r0r0r0r000r000000
0r000r0r0r000r000000
00r00r0r0r000rrr0rr0
000r0rrr0r000r000000
0r0r0r0r0r000r000000
00r00r0r0rrr0rrr0000
00000000000000000000
r000r00r00rrr0r00rrr
rr0rr0r0r0r000r000r0
r0r0r0rrr0rrr0r000r0
r000r0r0r0r000r000r0
r000r0r0r0rrr0rr0rrr
00000000000000000000
0bbb000bbb000bbb0000
00000000000000000000
0000ggg000ggg000ggg0
00000000000000000000
m00m00y00y00m00y000m